10
8
...#####..
..<.#...#.
.####.#^#.
......#...
#..####^#.
#..^#.....
###...#^##
....#....>
