10
10
<#.^^#....
..#..#..^.
.#...#....
...#.#^...
........^.
..^..#....
...^..#...
..........
.#...#..##
.........>

